{
  "name": "Demo Level",
  "width": 10,
  "height": 6,
  "startX": 160,
  "startY": 96,
  "tileSrc": "../tiles.png",
  "tiles": [
    {
      "id": 0,
      "height": [0,0,0,0,0,0,0,0,0,0,0,0,0,0,0,0],
      "hFlip": false,
      "vFlip": false,
      "angle": 0,
      "solid": [],
      "textures": [0,0,0,0]
    },
    {
      "id": 1,
      "height": [16,16,16,16,16,16,16,16,16,16,16,16,16,16,16,16],
      "hFlip": false,
      "vFlip": false,
      "angle": 0,
      "solid": [0, 1, 2, 3],
      "textures": [1,1,1,1]
    },
    {
      "id": 2,
      "height": [16, 16, 15, 15, 14, 14, 13, 13, 12, 12, 11, 11, 10, 10, 9, 9],
      "hFlip": false,
      "vFlip": false,
      "angle": 5.890486225480862,
      "solid": [0, 1, 2, 3],
      "textures": [3,4,1,1]
    },
    {
      "id": 3,
      "height": [8, 8, 7, 7, 6, 6, 5, 5, 4, 4, 3, 3, 2, 2, 1, 1],
      "hFlip": false,
      "vFlip": false,
      "angle": 5.890486225480862,
      "solid": [0, 1, 2, 3],
      "textures": [0,0,3,4]
    },
    {
      "id": 4,
      "height": [16, 16, 15, 15, 14, 14, 13, 13, 12, 12, 11, 11, 10, 10, 9, 9],
      "hFlip": true,
      "vFlip": false,
      "angle": 0.39269908169872414,
      "solid": [0, 1, 2, 3],
      "textures": [3,4,1,1]
    },
    {
      "id": 5,
      "height": [8, 8, 7, 7, 6, 6, 5, 5, 4, 4, 3, 3, 2, 2, 1, 1],
      "hFlip": true,
      "vFlip": false,
      "angle": 0.39269908169872414,
      "solid": [0, 1, 2, 3],
      "textures": [0,0,3,4]
    }
  ],
  "chunks": [
    {
      "id": 0,
      "tiles": [
        0, 0, 0, 0, 0, 0, 0, 0,
        0, 0, 0, 0, 0, 0, 0, 0,
        0, 0, 0, 0, 0, 0, 0, 0,
        0, 0, 0, 0, 0, 0, 0, 0,
        0, 0, 0, 0, 0, 0, 0, 0,
        0, 0, 0, 0, 0, 0, 0, 0,
        0, 0, 0, 0, 0, 0, 0, 0,
        0, 0, 0, 0, 0, 0, 0, 0
      ]
    },
    {
      "id": 1,
      "tiles": [
        1, 1, 1, 1, 1, 1, 1, 1,
        1, 1, 1, 1, 1, 1, 1, 1,
        1, 1, 1, 1, 1, 1, 1, 1,
        1, 1, 1, 1, 1, 1, 1, 1,
        1, 1, 1, 1, 1, 1, 1, 1,
        1, 1, 1, 1, 1, 1, 1, 1,
        1, 1, 1, 1, 1, 1, 1, 1,
        1, 1, 1, 1, 1, 1, 1, 1
      ]
    },
    {
      "id": 2,
      "tiles": [
        2, 3, 0, 0, 0, 0, 0, 0,
        1, 1, 2, 3, 0, 0, 0, 0,
        1, 1, 1, 1, 2, 3, 0, 0,
        1, 1, 1, 1, 1, 1, 2, 3,
        1, 1, 1, 1, 1, 1, 1, 1,
        1, 1, 1, 1, 1, 1, 1, 1,
        1, 1, 1, 1, 1, 1, 1, 1,
        1, 1, 1, 1, 1, 1, 1, 1
      ]
    },
    {
      "id": 3,
      "tiles": [
        0, 0, 0, 0, 0, 0, 5, 4,
        0, 0, 0, 0, 5, 4, 1, 1,
        0, 0, 5, 4, 1, 1, 1, 1,
        5, 4, 1, 1, 1, 1, 1, 1,
        1, 1, 1, 1, 1, 1, 1, 1,
        1, 1, 1, 1, 1, 1, 1, 1,
        1, 1, 1, 1, 1, 1, 1, 1,
        1, 1, 1, 1, 1, 1, 1, 1
      ]
    },
    {
      "id": 4,
      "tiles": [
        0, 0, 0, 0, 0, 0, 0, 0,
        0, 0, 0, 0, 0, 0, 0, 0,
        0, 0, 0, 0, 0, 0, 0, 0,
        0, 0, 0, 0, 0, 0, 0, 0,
        1, 1, 1, 1, 1, 1, 1, 1,
        1, 1, 1, 1, 1, 1, 1, 1,
        1, 1, 1, 1, 1, 1, 1, 1,
        1, 1, 1, 1, 1, 1, 1, 1
      ]
    },
    {
      "id": 5,
      "tiles": [
        0, 0, 0, 0, 0, 0, 0, 0,
        0, 0, 0, 0, 0, 0, 0, 0,
        0, 0, 0, 0, 0, 0, 0, 0,
        0, 0, 0, 0, 0, 0, 0, 0,
        2, 3, 0, 0, 0, 0, 0, 0,
        1, 1, 2, 3, 0, 0, 0, 0,
        1, 1, 1, 1, 2, 3, 0, 0,
        1, 1, 1, 1, 1, 1, 2, 3
      ]
    },
    {
      "id": 6,
      "tiles": [
        0, 0, 0, 0, 0, 0, 0, 0,
        0, 0, 0, 0, 0, 0, 0, 0,
        0, 0, 0, 0, 0, 0, 0, 0,
        0, 0, 0, 0, 0, 0, 0, 0,
        0, 0, 0, 0, 0, 0, 5, 4,
        0, 0, 0, 0, 5, 4, 1, 1,
        0, 0, 5, 4, 1, 1, 1, 1,
        5, 4, 1, 1, 1, 1, 1, 1
      ]
    }
  ],
  "data": [
    1, 0, 0, 0, 0, 0, 0, 0, 0, 6,
    1, 1, 2, 5, 0, 0, 3, 1, 1, 1,
    1, 1, 1, 1, 1, 0, 0, 0, 1, 1,
    1, 0, 0, 0, 0, 0, 6, 4, 1, 1,
    1, 0, 0, 6, 3, 1, 1, 1, 1, 1,
    1, 1, 1, 1, 1, 1, 1, 1, 1, 1
  ]
}